#########################
#     #     #          .#
#     #     #           #
#     #     #           #
#   #$#$#               #
#           #           #
#           #           #
###### ##################
#           #           #
#           #       #   #
#     #     #       $   #
#  #$###$#          #   #
#     #     #       $   #
#           #       #   #
#           #         @  
#########################